4 4 4 2 1 1 1 1 1 1 3 1 4 4 
4 4 4 4 4 4 6 5 5 4 5 1 4 4
4 4 4 4 7 4 6 5 5 5 5 4 5 5
4 4 6 7 7 7 5 5 5 5 5 5 5 5
4 4 6 7 7 7 5 5 5 5 5 5 5 5
4 4 4 6 7 7 4 4 4 4 4 4 4 4
4 4 4 6 7 7 4 4 4 4 4 4 4 4
4 4 4 6 1 7 4 4 4 4 4 4 4 4
4 4 4 6 1 1 4 4 4 4 4 4 4 4
4 4 6 6 6 1 1 4 4 4 4 4 4 4
4 4 6 6 6 6 1 1 4 4 4 4 4 4
4 4 6 6 6 6 6 1 1 1 1 1 1 3
4 4 6 4 4 1 1 5 5 5 6 6 6 6
4 4 4 4 4 4 1 5 5 5 6 6 6 6
4 4 4 4 4 4 1 5 5 5 6 6 6 6