2 7 7 7 7 7 5 5 5 5 5 5 5 5
1 7 7 7 7 7 5 5 5 5 5 5 5 5
1 7 7 7 7 7 5 5 5 5 5 5 5 5
1 7 7 7 7 7 5 5 5 5 5 5 5 5
1 7 7 7 7 7 5 5 5 5 5 5 5 5
1 1 1 7 7 7 4 4 4 4 4 4 4 4
6 6 1 1 7 7 4 4 4 4 4 4 4 4
6 6 0 1 1 7 4 4 4 4 4 4 4 4
6 6 6 6 1 1 4 4 4 4 4 4 4 4
6 6 6 6 6 1 1 4 4 4 4 4 4 4
6 6 6 6 6 6 1 1 4 4 4 4 4 4
6 6 6 6 6 6 6 1 1 1 1 1 1 3
