4 4 4 2 1 1 1 1 1 1 1 1 3 4 4
4 4 4 4 4 4 1 1 1 1 4 5 4 4 4
4 4 4 6 6 4 1 4 1 1 5 5 4 1 1
4 4 6 6 6 6 1 4 1 1 5 5 1 1 1
4 4 6 6 6 6 1 4 4 1 1 5 1 1 1
4 4 4 6 6 1 1 1 1 1 1 5 5 5 5
4 4 4 7 7 7 1 1 1 1 1 5 5 5 5
4 4 4 1 7 4 4 1 1 5 5 5 5 6 6
4 4 4 1 1 4 4 7 1 5 5 5 6 6 6
4 4 1 1 1 1 7 7 7 5 5 6 6 6 6
4 4 1 1 1 1 1 1 5 5 5 6 6 6 6
4 4 1 1 1 1 1 1 5 5 6 6 6 6 6
4 4 1 4 4 1 1 5 5 5 6 6 6 6 6
4 4 4 4 4 4 1 5 5 5 6 6 6 6 6
4 4 4 4 4 4 1 5 5 5 6 6 6 6 6